1111111111111111111111
1E0C000000000000010001
11111P0000000000110C01
1000100000000C00000001
1000000010000111110001
1000C0001000010C010001
1000000000000100000001
1111111111111111111111