1111111111
1P0000C001
1000C000E1
1111111111