1111111111111111111111111
1P0000000000C0C00000000E1
1000000000000C00001111101
101110000000C0C0000000101
1000010000000000000000101
100C010000000000111110101
10000000000000000C1C00001
1111111111111111111111111