1111111111111
1000000000001
1PCC0C0C0CE11
1111111111111