11111111111
1P0000100E1
10010000C01
11111111111
