1111111110111
1000000000001
1PCC0C0C0CEE1
1111111111111