111111011
1P00E00C1
100000001
111111111