111111111
1P00E00C1
100000001
111110111