111111111
1P00E00C1
000000001
111111111