111111111
1000000C1
1000000E1
111111111