111111111
1P00E00C1
100000000
111111111