111111111
1PC000E0111
111111111