111111111
1P00000C1
100000001
111111111